Donald	Duck	m
Dagobert	Duck	m
Daisy	Duck	w
Gustav	Gans	m
Darkwing	Duck	m
Kuno	Knock	d
Gitta	Gans	w
Gundel	Gauckeley	w
Fenton (Krachbummente)	Duck	m
Trick	Duck	m
Tick	Duck	m
Track	Duck	m
Dicky	Duck	w
Dacky	Duck	w
Ducky	Duck	w
Mickey	Mouse	m
Minnie	Mouse	w
Kater	Carlo	m
Klara	Katze	w
Bart	Simpson	m
